XXXXXXXXXXXXXXXXXXXXXX
X1a332X23112X1311X12XX
XXX2XX111X231X111XbXXX
X1211X1132X12221113XXX
X12122X111331XXX32313X
X13112Xd3212XXX111221X
X11111111111111111111X
XX3232X313XXXX111XXX1X
X22131X121XcXX11121XXX
X1113XXX211X11131X222X
X1111XeX1111111111111X
XXXXXXXXXXXXXXXXXXXXXX
